1111111111111
1EY00000000C1
1010101C10101
1P10101C10101
10000000000C1
1111111111111
