111111
1C00P1
10P001
100E01
111111
