11111111111111111111
1CCCC1CCCCCCCC10CCC1
10Y101C111111C1C1EC1
1C1CCCC00000CCCCC1C1
1C1C11C110011C11C1C1
101C00C111111C11C1C1
1C1CCCCC0P0CCCCCC1C1
1C1101C111111C1CY1C1
10C0C1CCC000CC1CC0C1
11111111111111111111
