11111111
1000E001
1C000001
1P00X001
11111111
