11111111
1000E001
1C000001
1P00E001
11111111
