11111111111111111
10Y1CC000CC0C11C1
1C11C1CC1C0C01C01
1C1C011111Y0C11C1
1P0011E0CC00CC001
11111111111111111
