111111111
1000E0101
1C00001C1
1P00C0101
111111111
