11111111
100000P1
1C000001
1P00E001
11111111
