11111111
1000C001
1C00001
1P00E001
11111111
